##########
#___#____#
#_@_#$___#
###_$__###
#_#.$.!__#
#___##___#
#___$!___#
##########
#$_$_$_$_#
##########