#######
#_____#
#_____#
#._#__#
#._$$_#
#.$$__#
#.#__@#
#######