##########
#..__#___#
#.$$$$$__#
#.._____@#
#________#
##########
#$_$_$_$_#
##########