##########
#___##___#
#_$_$____#
#_#.#_#_##
#_$!.@$_.#
#____#__.# 
###___####
#_______##
##########
