1
#######____
###___#____
#.__$_#____
###_$.#____
#.##$_#____
#_#_@_##___
#$_!$$.#___
#___.__#___
########___
___________
___________
